EA ./textures/wood.xpm
NO ./textures/brick.xpm
SO ./textures/blue.xpm      
WE ./textures/grey.xpm
C 0, 30, 100  
F 0, 255, 0

111111111111      
1111111111111     
1100001111111111111                     
11000100000000001                              
11100000000000011110             
111000000000N000001
100000001111100001111111111111111               
10000000001111111111111
10000000001
10000000001
11111111111



